DATE;HOME;AWAY;FTHG;FTAG;DIFF
11/06/2023;FC Emmen;Almere City;1;2;-1
11/06/2023;Twente;Sparta Rotterdam;1;0;1
08/06/2023;Sparta Rotterdam;Twente;1;1;0
06/06/2023;Almere City;FC Emmen;2;0;2
04/06/2023;Sparta Rotterdam;Utrecht;1;1;0
04/06/2023;Twente;Heerenveen;4;0;4
03/06/2023;FC Emmen;NAC Breda;2;0;2
03/06/2023;Almere City;Venlo;2;1;1
01/06/2023;Utrecht;Sparta Rotterdam;1;2;-1
01/06/2023;Heerenveen;Twente;1;2;-1
31/05/2023;NAC Breda;FC Emmen;1;2;-1
30/05/2023;Venlo;Almere City;1;1;0
28/05/2023;AZ Alkmaar;PSV;1;2;-1
28/05/2023;Cambuur;Waalwijk;4;0;4
28/05/2023;FC Volendam;Excelsior;3;2;1
28/05/2023;Feyenoord;Vitesse;0;1;-1
28/05/2023;Groningen;Sparta Rotterdam;0;5;-5
28/05/2023;Heerenveen;G.A. Eagles;2;0;2
28/05/2023;Sittard;Nijmegen;1;1;0
28/05/2023;Twente;Ajax;3;1;2
28/05/2023;Utrecht;FC Emmen;3;2;1
27/05/2023;Maastricht;NAC Breda;1;4;-3
27/05/2023;Willem II;Venlo;2;2;0
26/05/2023;Almere City;Eindhoven FC;3;1;2
23/05/2023;NAC Breda;Maastricht;1;0;1
23/05/2023;Venlo;Willem II;3;2;1
22/05/2023;Eindhoven FC;Almere City;1;0;1
21/05/2023;Ajax;Utrecht;3;1;2
21/05/2023;Excelsior;Sittard;3;0;3
21/05/2023;FC Emmen;Feyenoord;1;3;-2
21/05/2023;G.A. Eagles;FC Volendam;3;0;3
21/05/2023;Nijmegen;AZ Alkmaar;0;3;-3
21/05/2023;PSV;Heerenveen;3;3;0
21/05/2023;Sparta Rotterdam;Cambuur;4;1;3
21/05/2023;Vitesse;Groningen;6;0;6
21/05/2023;Waalwijk;Twente;0;5;-5
16/05/2023;Groningen;Ajax;2;3;-1
14/05/2023;AZ Alkmaar;FC Emmen;5;1;4
14/05/2023;PSV;Sittard;2;1;1
14/05/2023;Feyenoord;G.A. Eagles;3;0;3
14/05/2023;Vitesse;Cambuur;2;0;2
13/05/2023;Utrecht;Waalwijk;2;0;2
13/05/2023;Heerenveen;Excelsior;0;0;0
13/05/2023;FC Volendam;Sparta Rotterdam;2;1;1
12/05/2023;Twente;Nijmegen;4;0;4
07/05/2023;Sittard;Vitesse;2;0;2
07/05/2023;Excelsior;Feyenoord;0;2;-2
07/05/2023;G.A. Eagles;Groningen;1;1;0
07/05/2023;FC Emmen;Twente;0;3;-3
06/05/2023;Ajax;AZ Alkmaar;0;0;0
06/05/2023;Cambuur;Utrecht;0;3;-3
06/05/2023;Nijmegen;Heerenveen;2;3;-1
06/05/2023;Sparta Rotterdam;PSV;0;1;-1
05/05/2023;Waalwijk;FC Volendam;4;1;3
25/04/2023;Groningen;Nijmegen;0;1;-1
23/04/2023;AZ Alkmaar;Waalwijk;3;0;3
23/04/2023;Feyenoord;Utrecht;3;1;2
23/04/2023;G.A. Eagles;Sittard;2;0;2
23/04/2023;PSV;Ajax;3;0;3
23/04/2023;Twente;Sparta Rotterdam;3;3;0
22/04/2023;Vitesse;Excelsior;0;0;0
22/04/2023;Heerenveen;FC Emmen;2;3;-1
21/04/2023;FC Volendam;Cambuur;2;0;2
19/04/2023;G.A. Eagles;Waalwijk;3;2;1
16/04/2023;Ajax;FC Emmen;3;1;2
16/04/2023;Sittard;AZ Alkmaar;0;3;-3
16/04/2023;Cambuur;Feyenoord;0;3;-3
16/04/2023;FC Volendam;PSV;2;3;-1
16/04/2023;Utrecht;Twente;1;0;1
16/04/2023;Nijmegen;Vitesse;1;4;-3
15/04/2023;Sparta Rotterdam;Heerenveen;4;0;4
15/04/2023;Waalwijk;Groningen;2;1;1
14/04/2023;Excelsior;G.A. Eagles;2;1;1
09/04/2023;Feyenoord;Waalwijk;5;1;4
09/04/2023;Ajax;Sittard;4;0;4
09/04/2023;FC Emmen;Nijmegen;0;0;0
09/04/2023;Twente;Cambuur;4;0;4
08/04/2023;Heerenveen;FC Volendam;2;1;1
08/04/2023;AZ Alkmaar;Sparta Rotterdam;0;1;-1
08/04/2023;PSV;Excelsior;4;0;4
08/04/2023;Vitesse;G.A. Eagles;2;0;2
07/04/2023;Groningen;Utrecht;1;2;-1
02/04/2023;Sittard;Groningen;3;1;2
02/04/2023;Sparta Rotterdam;Feyenoord;1;3;-2
02/04/2023;Utrecht;FC Volendam;0;0;0
02/04/2023;G.A. Eagles;Ajax;0;0;0
01/04/2023;Waalwijk;Vitesse;1;0;1
01/04/2023;Cambuur;FC Emmen;1;2;-1
01/04/2023;Nijmegen;PSV;2;4;-2
01/04/2023;Excelsior;Twente;0;0;0
01/04/2023;AZ Alkmaar;Heerenveen;1;1;0
19/03/2023;Twente;AZ Alkmaar;2;1;1
19/03/2023;Vitesse;PSV;1;1;0
19/03/2023;Ajax;Feyenoord;2;3;-1
19/03/2023;Excelsior;Cambuur;4;1;3
19/03/2023;Groningen;Heerenveen;0;2;-2
18/03/2023;Waalwijk;Nijmegen;1;3;-2
18/03/2023;FC Emmen;Sparta Rotterdam;0;2;-2
18/03/2023;Utrecht;G.A. Eagles;1;2;-1
17/03/2023;FC Volendam;Sittard;2;1;1
12/03/2023;Feyenoord;FC Volendam;2;1;1
12/03/2023;PSV;Cambuur;5;2;3
12/03/2023;Heerenveen;Ajax;2;4;-2
12/03/2023;Nijmegen;Utrecht;2;2;0
11/03/2023;Sparta Rotterdam;Vitesse;3;1;2
11/03/2023;AZ Alkmaar;Groningen;1;0;1
11/03/2023;Sittard;Twente;0;3;-3
11/03/2023;FC Emmen;Excelsior;2;0;2
05/03/2023;Cambuur;G.A. Eagles;4;1;3
05/03/2023;Ajax;Nijmegen;1;0;1
05/03/2023;Waalwijk;PSV;0;1;-1
05/03/2023;Excelsior;Sparta Rotterdam;1;4;-3
04/03/2023;Twente;Heerenveen;3;3;0
04/03/2023;Feyenoord;Groningen;1;0;1
04/03/2023;FC Volendam;FC Emmen;3;1;2
03/03/2023;Utrecht;Sittard;1;2;-1
03/03/2023;Vitesse;AZ Alkmaar;0;1;-1
26/02/2023;PSV;Twente;3;1;2
26/02/2023;FC Emmen;G.A. Eagles;2;2;0
26/02/2023;Vitesse;Ajax;1;2;-1
26/02/2023;Sittard;Feyenoord;2;4;-2
25/02/2023;Nijmegen;FC Volendam;3;0;3
25/02/2023;AZ Alkmaar;Cambuur;2;1;1
25/02/2023;Heerenveen;Waalwijk;1;4;-3
25/02/2023;Groningen;Excelsior;3;0;3
24/02/2023;Sparta Rotterdam;Utrecht;0;3;-3
19/02/2023;Excelsior;Nijmegen;0;3;-3
19/02/2023;Ajax;Sparta Rotterdam;4;0;4
19/02/2023;G.A. Eagles;Twente;2;0;2
19/02/2023;Utrecht;PSV;2;2;0
19/02/2023;Cambuur;Heerenveen;1;2;-1
18/02/2023;Feyenoord;AZ Alkmaar;2;1;1
18/02/2023;Groningen;FC Emmen;1;1;0
18/02/2023;FC Volendam;Vitesse;2;0;2
17/02/2023;Waalwijk;Sittard;3;1;2
12/02/2023;Ajax;Waalwijk;3;1;2
12/02/2023;Twente;FC Volendam;3;0;3
12/02/2023;Heerenveen;Feyenoord;1;2;-1
12/02/2023;Vitesse;Utrecht;2;0;2
12/02/2023;Sparta Rotterdam;G.A. Eagles;2;1;1
11/02/2023;FC Emmen;Sittard;0;1;-1
11/02/2023;PSV;Groningen;6;0;6
11/02/2023;Nijmegen;Cambuur;0;0;0
10/02/2023;AZ Alkmaar;Excelsior;5;0;5
05/02/2023;Groningen;Twente;1;1;0
05/02/2023;Feyenoord;PSV;2;2;0
05/02/2023;G.A. Eagles;Nijmegen;1;0;1
05/02/2023;Cambuur;Ajax;0;5;-5
04/02/2023;Excelsior;Waalwijk;0;0;0
04/02/2023;FC Emmen;Vitesse;2;2;0
04/02/2023;Utrecht;Heerenveen;1;0;1
04/02/2023;FC Volendam;AZ Alkmaar;1;1;0
03/02/2023;Sittard;Sparta Rotterdam;0;0;0
01/02/2023;Waalwijk;G.A. Eagles;3;1;2
29/01/2023;Cambuur;Sittard;1;2;-1
29/01/2023;Excelsior;Ajax;1;4;-3
29/01/2023;FC Volendam;Groningen;3;2;1
29/01/2023;Twente;Feyenoord;1;1;0
28/01/2023;AZ Alkmaar;Utrecht;5;5;0
28/01/2023;Heerenveen;Vitesse;1;3;-2
28/01/2023;Nijmegen;Sparta Rotterdam;1;1;0
28/01/2023;Waalwijk;FC Emmen;2;0;2
28/01/2023;PSV;G.A. Eagles;2;0;2
26/01/2023;Ajax;FC Volendam;1;1;0
26/01/2023;Groningen;Cambuur;0;1;-1
25/01/2023;Feyenoord;Nijmegen;2;0;2
25/01/2023;Utrecht;Excelsior;1;0;1
25/01/2023;Sittard;Heerenveen;2;0;2
25/01/2023;G.A. Eagles;AZ Alkmaar;1;4;-3
25/01/2023;Vitesse;Twente;2;2;0
24/01/2023;Sparta Rotterdam;Waalwijk;0;0;0
24/01/2023;FC Emmen;PSV;1;0;1
22/01/2023;AZ Alkmaar;Sittard;3;1;2
22/01/2023;Feyenoord;Ajax;1;1;0
22/01/2023;Twente;Utrecht;2;0;2
22/01/2023;Heerenveen;Groningen;3;1;2
21/01/2023;Cambuur;Sparta Rotterdam;0;3;-3
21/01/2023;PSV;Vitesse;1;0;1
21/01/2023;Nijmegen;FC Emmen;3;1;2
20/01/2023;Excelsior;FC Volendam;2;0;2
15/01/2023;FC Emmen;Cambuur;0;0;0
15/01/2023;Groningen;Feyenoord;0;3;-3
15/01/2023;G.A. Eagles;Utrecht;2;2;0
15/01/2023;Sittard;PSV;2;2;0
15/01/2023;Vitesse;Nijmegen;0;0;0
14/01/2023;Ajax;Twente;0;0;0
14/01/2023;Sparta Rotterdam;Excelsior;1;0;1
14/01/2023;FC Volendam;Waalwijk;2;1;1
14/01/2023;Heerenveen;AZ Alkmaar;0;2;-2
08/01/2023;Excelsior;Groningen;1;0;1
08/01/2023;Cambuur;FC Volendam;0;3;-3
08/01/2023;Nijmegen;Ajax;1;1;0
08/01/2023;Utrecht;Feyenoord;1;1;0
07/01/2023;PSV;Sparta Rotterdam;0;0;0
07/01/2023;Sittard;G.A. Eagles;0;2;-2
07/01/2023;AZ Alkmaar;Vitesse;1;1;0
07/01/2023;Waalwijk;Heerenveen;0;0;0
06/01/2023;Twente;FC Emmen;2;0;2
13/11/2022;G.A. Eagles;Vitesse;2;2;0
13/11/2022;Feyenoord;Excelsior;5;1;4
13/11/2022;Groningen;Sittard;2;3;-1
13/11/2022;Heerenveen;Cambuur;2;1;1
13/11/2022;Nijmegen;Waalwijk;6;1;5
12/11/2022;PSV;AZ Alkmaar;0;1;-1
12/11/2022;FC Emmen;Ajax;3;3;0
12/11/2022;FC Volendam;Utrecht;0;4;-4
11/11/2022;Sparta Rotterdam;Twente;1;1;0
10/11/2022;Feyenoord;Cambuur;1;0;1
09/11/2022;Ajax;Vitesse;2;2;0
06/11/2022;Ajax;PSV;1;2;-1
06/11/2022;Waalwijk;AZ Alkmaar;3;1;2
06/11/2022;FC Volendam;Feyenoord;0;2;-2
06/11/2022;Twente;G.A. Eagles;1;1;0
06/11/2022;Utrecht;Groningen;2;1;1
05/11/2022;Excelsior;Heerenveen;0;1;-1
05/11/2022;Sittard;FC Emmen;0;1;-1
05/11/2022;Vitesse;Sparta Rotterdam;0;4;-4
04/11/2022;Cambuur;Nijmegen;0;1;-1
30/10/2022;AZ Alkmaar;FC Volendam;2;1;1
30/10/2022;PSV;Nijmegen;3;0;3
30/10/2022;Twente;Waalwijk;3;0;3
30/10/2022;FC Emmen;Groningen;0;0;0
29/10/2022;G.A. Eagles;Excelsior;3;1;2
29/10/2022;Sparta Rotterdam;Sittard;3;1;2
29/10/2022;Heerenveen;Utrecht;1;2;-1
23/10/2022;FC Volendam;Heerenveen;1;3;-2
23/10/2022;Utrecht;Sparta Rotterdam;3;1;2
23/10/2022;Cambuur;Twente;0;1;-1
23/10/2022;Groningen;PSV;4;2;2
23/10/2022;Nijmegen;G.A. Eagles;3;3;0
23/10/2022;Excelsior;AZ Alkmaar;2;1;1
22/10/2022;Vitesse;FC Emmen;2;1;1
22/10/2022;Waalwijk;Ajax;1;4;-3
22/10/2022;Feyenoord;Sittard;1;1;0
16/10/2022;Ajax;Excelsior;7;1;6
16/10/2022;AZ Alkmaar;Feyenoord;1;3;-2
16/10/2022;PSV;Utrecht;6;1;5
16/10/2022;Twente;Groningen;3;0;3
16/10/2022;Sparta Rotterdam;Nijmegen;2;0;2
15/10/2022;Cambuur;Vitesse;0;3;-3
15/10/2022;G.A. Eagles;Heerenveen;1;1;0
15/10/2022;Sittard;Waalwijk;0;0;0
14/10/2022;FC Emmen;FC Volendam;1;1;0
09/10/2022;Vitesse;Sittard;1;2;-1
09/10/2022;Heerenveen;PSV;0;1;-1
09/10/2022;Feyenoord;Twente;2;0;2
09/10/2022;Utrecht;AZ Alkmaar;1;2;-1
09/10/2022;G.A. Eagles;Cambuur;0;0;0
08/10/2022;Nijmegen;Excelsior;1;1;0
08/10/2022;Sparta Rotterdam;FC Emmen;3;1;2
08/10/2022;FC Volendam;Ajax;2;4;-2
07/10/2022;Groningen;Waalwijk;2;3;-1
02/10/2022;FC Emmen;Heerenveen;0;0;0
02/10/2022;Waalwijk;Sparta Rotterdam;2;2;0
02/10/2022;Excelsior;Utrecht;0;1;-1
02/10/2022;Nijmegen;Feyenoord;1;1;0
02/10/2022;Sittard;FC Volendam;2;0;2
01/10/2022;Twente;Vitesse;3;0;3
01/10/2022;Ajax;G.A. Eagles;1;1;0
01/10/2022;Groningen;AZ Alkmaar;1;4;-3
01/10/2022;Cambuur;PSV;3;0;3
18/09/2022;AZ Alkmaar;Ajax;2;1;1
18/09/2022;Heerenveen;Twente;2;1;1
18/09/2022;PSV;Feyenoord;4;3;1
18/09/2022;G.A. Eagles;FC Emmen;2;0;2
17/09/2022;Sittard;Excelsior;1;0;1
17/09/2022;Waalwijk;Cambuur;5;1;4
17/09/2022;Vitesse;FC Volendam;1;1;0
17/09/2022;Sparta Rotterdam;Groningen;2;1;1
16/09/2022;Utrecht;Nijmegen;0;0;0
11/09/2022;Feyenoord;Sparta Rotterdam;3;0;3
11/09/2022;AZ Alkmaar;Twente;1;1;0
11/09/2022;Cambuur;Groningen;0;1;-1
11/09/2022;PSV;Waalwijk;1;0;1
11/09/2022;Utrecht;Vitesse;1;0;1
10/09/2022;Excelsior;FC Emmen;2;1;1
10/09/2022;Ajax;Heerenveen;5;0;5
10/09/2022;Nijmegen;Sittard;1;1;0
09/09/2022;FC Volendam;G.A. Eagles;2;3;-1
04/09/2022;Groningen;Vitesse;0;1;-1
04/09/2022;FC Emmen;AZ Alkmaar;0;3;-3
04/09/2022;Heerenveen;Nijmegen;0;0;0
04/09/2022;Waalwijk;Excelsior;5;2;3
03/09/2022;G.A. Eagles;Feyenoord;3;4;-1
03/09/2022;Sparta Rotterdam;FC Volendam;4;0;4
03/09/2022;Twente;PSV;2;1;1
03/09/2022;Ajax;Cambuur;4;0;4
02/09/2022;Sittard;Utrecht;3;4;-1
01/09/2022;AZ Alkmaar;Nijmegen;1;1;0
31/08/2022;Twente;Excelsior;4;0;4
31/08/2022;PSV;FC Volendam;7;1;6
28/08/2022;Cambuur;AZ Alkmaar;0;1;-1
28/08/2022;Excelsior;PSV;1;6;-5
28/08/2022;FC Volendam;Twente;1;0;1
28/08/2022;Utrecht;Ajax;0;2;-2
27/08/2022;Heerenveen;Sittard;2;1;1
27/08/2022;Feyenoord;FC Emmen;4;0;4
27/08/2022;Vitesse;Waalwijk;2;2;0
27/08/2022;G.A. Eagles;Sparta Rotterdam;0;1;-1
26/08/2022;Nijmegen;Groningen;1;1;0
21/08/2022;Waalwijk;Feyenoord;0;1;-1
21/08/2022;Sparta Rotterdam;Ajax;0;1;-1
21/08/2022;Groningen;G.A. Eagles;1;0;1
20/08/2022;FC Emmen;Utrecht;3;2;1
20/08/2022;Sittard;Cambuur;1;4;-3
20/08/2022;Vitesse;Heerenveen;0;4;-4
14/08/2022;Sparta Rotterdam;AZ Alkmaar;2;3;-1
14/08/2022;Ajax;Groningen;6;1;5
14/08/2022;Twente;Sittard;3;0;3
14/08/2022;FC Volendam;Nijmegen;1;4;-3
13/08/2022;Feyenoord;Heerenveen;0;0;0
13/08/2022;FC Emmen;Waalwijk;1;1;0
13/08/2022;Utrecht;Cambuur;0;0;0
13/08/2022;G.A. Eagles;PSV;2;5;-3
12/08/2022;Excelsior;Vitesse;3;1;2
07/08/2022;AZ Alkmaar;G.A. Eagles;2;0;2
07/08/2022;Nijmegen;Twente;0;1;-1
07/08/2022;Vitesse;Feyenoord;2;5;-3
07/08/2022;Groningen;FC Volendam;2;2;0
06/08/2022;Waalwijk;Utrecht;2;2;0
06/08/2022;PSV;FC Emmen;4;1;3
06/08/2022;Cambuur;Excelsior;0;2;-2
06/08/2022;Sittard;Ajax;2;3;-1
05/08/2022;Heerenveen;Sparta Rotterdam;0;0;0
