DATE;HOME;AWAY;FTHG;FTAG;DIFF
04/06/2023;Genk;Antwerp;2;2;0
04/06/2023;Royale Union SG;Club Brugge KV;1;3;-2
03/06/2023;Cercle Brugge KSV;Westerlo;2;0;2
03/06/2023;Gent;St. Liege;3;1;2
28/05/2023;Club Brugge KV;Genk;1;3;-2
28/05/2023;Antwerp;Royale Union SG;1;1;0
27/05/2023;St. Liege;Cercle Brugge KSV;0;4;-4
27/05/2023;Westerlo;Gent;1;3;-2
21/05/2023;Genk;Royale Union SG;1;1;0
21/05/2023;Club Brugge KV;Antwerp;2;0;2
20/05/2023;Gent;Cercle Brugge KSV;2;2;0
20/05/2023;Westerlo;St. Liege;3;0;3
14/05/2023;Royale Union SG;Genk;3;0;3
14/05/2023;Antwerp;Club Brugge KV;3;2;1
13/05/2023;St. Liege;Westerlo;2;2;0
13/05/2023;Cercle Brugge KSV;Gent;0;4;-4
07/05/2023;Antwerp;Genk;2;1;1
07/05/2023;Westerlo;Cercle Brugge KSV;3;5;-2
06/05/2023;St. Liege;Gent;1;2;-1
06/05/2023;Club Brugge KV;Royale Union SG;1;2;-1
03/05/2023;Royale Union SG;Antwerp;0;2;-2
30/04/2023;Genk;Club Brugge KV;3;1;2
29/04/2023;Cercle Brugge KSV;St. Liege;0;0;0
28/04/2023;Gent;Westerlo;3;1;2
23/04/2023;Anderlecht;KV Mechelen;2;3;-1
23/04/2023;Charleroi;Genk;2;2;0
23/04/2023;Club Brugge KV;Eupen;7;0;7
23/04/2023;Gent;Oostende;1;2;-1
23/04/2023;Kortrijk;Royale Union SG;2;4;-2
23/04/2023;Leuven;St. Liege;3;2;1
23/04/2023;Waregem;Cercle Brugge KSV;2;3;-1
23/04/2023;St. Truiden;Antwerp;0;1;-1
22/04/2023;Seraing;Westerlo;1;1;0
16/04/2023;Royale Union SG;Seraing;2;1;1
16/04/2023;Antwerp;Kortrijk;1;0;1
16/04/2023;KV Mechelen;Gent;1;1;0
16/04/2023;Genk;Anderlecht;5;2;3
15/04/2023;Westerlo;Club Brugge KV;0;0;0
15/04/2023;Cercle Brugge KSV;St. Truiden;3;1;2
15/04/2023;Oostende;Leuven;0;4;-4
15/04/2023;Eupen;Waregem;1;5;-4
14/04/2023;St. Liege;Charleroi;3;1;2
09/04/2023;St. Truiden;Oostende;5;0;5
09/04/2023;St. Liege;Genk;2;0;2
09/04/2023;Antwerp;Cercle Brugge KSV;2;1;1
09/04/2023;Anderlecht;Westerlo;0;0;0
08/04/2023;Gent;Royale Union SG;1;1;0
08/04/2023;Charleroi;Waregem;3;2;1
08/04/2023;Kortrijk;Eupen;0;0;0
08/04/2023;Leuven;KV Mechelen;4;1;3
07/04/2023;Club Brugge KV;Seraing;2;0;2
02/04/2023;Royale Union SG;St. Truiden;2;1;1
02/04/2023;KV Mechelen;Club Brugge KV;0;3;-3
02/04/2023;Eupen;Anderlecht;0;1;-1
02/04/2023;Genk;Leuven;2;1;1
01/04/2023;Oostende;St. Liege;1;3;-2
01/04/2023;Seraing;Gent;0;5;-5
01/04/2023;Westerlo;Charleroi;2;3;-1
01/04/2023;Cercle Brugge KSV;Kortrijk;2;0;2
31/03/2023;Waregem;Antwerp;0;2;-2
19/03/2023;Gent;Eupen;3;0;3
19/03/2023;Royale Union SG;KV Mechelen;2;1;1
19/03/2023;Leuven;Anderlecht;0;2;-2
19/03/2023;Antwerp;Charleroi;0;1;-1
18/03/2023;St. Liege;Waregem;2;2;0
18/03/2023;Oostende;Westerlo;1;2;-1
18/03/2023;St. Truiden;Seraing;2;1;1
18/03/2023;Kortrijk;Club Brugge KV;1;0;1
17/03/2023;Cercle Brugge KSV;Genk;1;1;0
12/03/2023;Anderlecht;Cercle Brugge KSV;2;0;2
12/03/2023;Genk;Royale Union SG;1;2;-1
12/03/2023;Waregem;Gent;2;6;-4
12/03/2023;Club Brugge KV;St. Liege;2;0;2
11/03/2023;Seraing;Antwerp;0;2;-2
11/03/2023;Eupen;Oostende;4;4;0
11/03/2023;Westerlo;Kortrijk;3;1;2
11/03/2023;KV Mechelen;St. Truiden;1;0;1
10/03/2023;Charleroi;Leuven;0;1;-1
05/03/2023;Royale Union SG;Eupen;2;1;1
05/03/2023;Gent;Anderlecht;1;0;1
05/03/2023;Antwerp;KV Mechelen;5;0;5
05/03/2023;St. Truiden;Genk;2;2;0
04/03/2023;St. Liege;Westerlo;2;0;2
04/03/2023;Cercle Brugge KSV;Seraing;3;1;2
04/03/2023;Leuven;Waregem;4;2;2
04/03/2023;Kortrijk;Charleroi;0;1;-1
03/03/2023;Oostende;Club Brugge KV;3;0;3
26/02/2023;Charleroi;St. Truiden;1;0;1
26/02/2023;Anderlecht;St. Liege;2;2;0
26/02/2023;Leuven;Antwerp;1;1;0
26/02/2023;Club Brugge KV;Gent;2;0;2
25/02/2023;Westerlo;Royale Union SG;4;2;2
25/02/2023;Eupen;Cercle Brugge KSV;2;2;0
25/02/2023;Genk;Oostende;3;0;3
25/02/2023;Seraing;KV Mechelen;0;2;-2
24/02/2023;Waregem;Kortrijk;3;3;0
19/02/2023;St. Truiden;Westerlo;0;1;-1
19/02/2023;Kortrijk;Anderlecht;2;2;0
19/02/2023;Gent;Leuven;2;0;2
19/02/2023;Cercle Brugge KSV;Club Brugge KV;2;2;0
18/02/2023;Royale Union SG;St. Liege;2;4;-2
18/02/2023;Oostende;Charleroi;0;0;0
18/02/2023;Seraing;Waregem;1;1;0
18/02/2023;Antwerp;Eupen;2;0;2
17/02/2023;KV Mechelen;Genk;2;2;0
12/02/2023;Waregem;Oostende;1;1;0
12/02/2023;St. Liege;Kortrijk;0;2;-2
12/02/2023;Anderlecht;St. Truiden;3;1;2
12/02/2023;Genk;Antwerp;0;1;-1
11/02/2023;Charleroi;Seraing;3;0;3
11/02/2023;Westerlo;Gent;3;3;0
10/02/2023;Club Brugge KV;Royale Union SG;1;1;0
10/02/2023;Eupen;KV Mechelen;2;1;1
10/02/2023;Leuven;Cercle Brugge KSV;0;0;0
05/02/2023;Royale Union SG;Waregem;4;0;4
05/02/2023;Gent;Genk;2;3;-1
05/02/2023;KV Mechelen;Charleroi;2;2;0
05/02/2023;Antwerp;Club Brugge KV;0;0;0
04/02/2023;St. Truiden;Kortrijk;1;0;1
04/02/2023;Eupen;Westerlo;1;1;0
04/02/2023;Seraing;Leuven;2;1;1
04/02/2023;Cercle Brugge KSV;St. Liege;1;1;0
03/02/2023;Oostende;Anderlecht;0;2;-2
01/02/2023;Eupen;Genk;1;1;0
29/01/2023;Genk;Seraing;4;0;4
29/01/2023;Waregem;Club Brugge KV;1;2;-1
29/01/2023;Cercle Brugge KSV;Gent;3;2;1
29/01/2023;Anderlecht;Antwerp;0;0;0
28/01/2023;Charleroi;Royale Union SG;0;1;-1
28/01/2023;Kortrijk;Oostende;2;2;0
28/01/2023;Leuven;St. Truiden;1;1;0
28/01/2023;Westerlo;KV Mechelen;2;0;2
27/01/2023;St. Liege;Eupen;3;1;2
22/01/2023;St. Truiden;Gent;0;3;-3
22/01/2023;Club Brugge KV;Charleroi;2;2;0
22/01/2023;Seraing;Anderlecht;0;1;-1
22/01/2023;Antwerp;St. Liege;4;1;3
21/01/2023;Royale Union SG;Leuven;1;0;1
21/01/2023;KV Mechelen;Kortrijk;3;2;1
21/01/2023;Oostende;Cercle Brugge KSV;1;2;-1
21/01/2023;Waregem;Westerlo;1;1;0
19/01/2023;St. Truiden;Club Brugge KV;1;1;0
19/01/2023;Gent;Charleroi;0;0;0
18/01/2023;Anderlecht;Waregem;2;3;-1
18/01/2023;Kortrijk;Seraing;3;2;1
18/01/2023;Cercle Brugge KSV;Royale Union SG;1;1;0
18/01/2023;Oostende;Antwerp;0;3;-3
17/01/2023;St. Liege;KV Mechelen;2;0;2
17/01/2023;Westerlo;Genk;2;3;-1
17/01/2023;Leuven;Eupen;1;1;0
15/01/2023;Charleroi;Cercle Brugge KSV;2;1;1
15/01/2023;Royale Union SG;Antwerp;2;0;2
15/01/2023;Gent;Kortrijk;2;1;1
15/01/2023;Club Brugge KV;Anderlecht;1;1;0
14/01/2023;Genk;Waregem;1;0;1
14/01/2023;Eupen;St. Truiden;0;2;-2
14/01/2023;KV Mechelen;Oostende;2;1;1
14/01/2023;Seraing;St. Liege;1;1;0
13/01/2023;Westerlo;Leuven;1;2;-1
08/01/2023;Leuven;Kortrijk;2;3;-1
08/01/2023;Anderlecht;Royale Union SG;1;3;-2
08/01/2023;Waregem;KV Mechelen;2;0;2
08/01/2023;Genk;Club Brugge KV;3;1;2
07/01/2023;Antwerp;Gent;2;0;2
07/01/2023;Cercle Brugge KSV;Westerlo;0;1;-1
07/01/2023;Oostende;Seraing;1;2;-1
07/01/2023;Eupen;Charleroi;1;2;-1
06/01/2023;St. Liege;St. Truiden;1;1;0
27/12/2022;St. Truiden;Waregem;2;0;2
27/12/2022;Westerlo;Antwerp;3;3;0
26/12/2022;Charleroi;Anderlecht;0;1;-1
26/12/2022;Kortrijk;Genk;1;0;1
26/12/2022;Royale Union SG;Oostende;3;0;3
26/12/2022;Club Brugge KV;Leuven;1;1;0
23/12/2022;Gent;St. Liege;0;0;0
23/12/2022;KV Mechelen;Cercle Brugge KSV;1;1;0
23/12/2022;Seraing;Eupen;0;1;-1
13/11/2022;Kortrijk;Gent;0;4;-4
13/11/2022;Anderlecht;Genk;0;2;-2
13/11/2022;St. Liege;Royale Union SG;2;3;-1
13/11/2022;Club Brugge KV;Antwerp;2;2;0
12/11/2022;Charleroi;KV Mechelen;0;5;-5
12/11/2022;St. Truiden;Cercle Brugge KSV;0;1;-1
12/11/2022;Waregem;Eupen;5;5;0
12/11/2022;Westerlo;Oostende;6;0;6
11/11/2022;Leuven;Seraing;5;0;5
06/11/2022;Oostende;Kortrijk;3;1;2
06/11/2022;Antwerp;Anderlecht;0;0;0
06/11/2022;Royale Union SG;Westerlo;1;1;0
06/11/2022;Gent;Club Brugge KV;2;0;2
05/11/2022;Eupen;St. Liege;2;0;2
05/11/2022;Cercle Brugge KSV;Leuven;2;1;1
05/11/2022;Seraing;St. Truiden;1;2;-1
05/11/2022;KV Mechelen;Waregem;2;2;0
04/11/2022;Genk;Charleroi;4;1;3
30/10/2022;Charleroi;Antwerp;1;0;1
30/10/2022;Leuven;Gent;1;1;0
30/10/2022;Seraing;Royale Union SG;1;2;-1
30/10/2022;Anderlecht;Eupen;4;2;2
29/10/2022;Club Brugge KV;Oostende;4;2;2
29/10/2022;Kortrijk;Cercle Brugge KSV;1;1;0
29/10/2022;Westerlo;St. Truiden;2;3;-1
29/10/2022;Waregem;St. Liege;0;3;-3
28/10/2022;Genk;KV Mechelen;3;1;2
23/10/2022;Oostende;Waregem;2;1;1
23/10/2022;St. Liege;Anderlecht;5;0;5
23/10/2022;Gent;Seraing;2;1;1
23/10/2022;Antwerp;Genk;1;3;-2
22/10/2022;Royale Union SG;Club Brugge KV;2;2;0
22/10/2022;KV Mechelen;Eupen;2;1;1
22/10/2022;St. Truiden;Leuven;0;0;0
22/10/2022;Kortrijk;Westerlo;0;2;-2
21/10/2022;Cercle Brugge KSV;Charleroi;4;1;3
20/10/2022;Waregem;Anderlecht;3;2;1
20/10/2022;Antwerp;Oostende;3;0;3
19/10/2022;Club Brugge KV;St. Truiden;3;0;3
19/10/2022;KV Mechelen;St. Liege;2;0;2
19/10/2022;Royale Union SG;Gent;2;0;2
18/10/2022;Genk;Westerlo;6;1;5
18/10/2022;Seraing;Cercle Brugge KSV;0;1;-1
18/10/2022;Charleroi;Kortrijk;2;2;0
18/10/2022;Eupen;Leuven;4;2;2
16/10/2022;Oostende;Royale Union SG;1;6;-5
16/10/2022;Anderlecht;Club Brugge KV;0;1;-1
16/10/2022;Gent;KV Mechelen;3;0;3
16/10/2022;St. Liege;Antwerp;3;0;3
15/10/2022;Leuven;Genk;0;1;-1
15/10/2022;Cercle Brugge KSV;Eupen;5;1;4
15/10/2022;St. Truiden;Charleroi;2;1;1
15/10/2022;Kortrijk;Waregem;1;3;-2
14/10/2022;Westerlo;Seraing;2;2;0
09/10/2022;Royale Union SG;Cercle Brugge KSV;2;1;1
09/10/2022;Charleroi;St. Liege;0;1;-1
09/10/2022;Eupen;Gent;0;4;-4
09/10/2022;KV Mechelen;Anderlecht;1;3;-2
08/10/2022;Club Brugge KV;Westerlo;0;2;-2
08/10/2022;Seraing;Oostende;1;1;0
08/10/2022;Waregem;Leuven;2;5;-3
08/10/2022;Genk;Kortrijk;2;1;1
07/10/2022;Antwerp;St. Truiden;2;0;2
02/10/2022;St. Truiden;Eupen;0;1;-1
02/10/2022;Kortrijk;Antwerp;2;1;1
02/10/2022;Gent;Cercle Brugge KSV;3;4;-1
02/10/2022;Anderlecht;Charleroi;0;1;-1
01/10/2022;Club Brugge KV;KV Mechelen;3;0;3
01/10/2022;Oostende;Genk;1;2;-1
01/10/2022;Westerlo;Waregem;2;0;2
01/10/2022;Leuven;Royale Union SG;0;3;-3
30/09/2022;St. Liege;Seraing;0;2;-2
18/09/2022;Anderlecht;Kortrijk;4;1;3
18/09/2022;St. Liege;Club Brugge KV;3;0;3
18/09/2022;Eupen;Royale Union SG;1;2;-1
18/09/2022;Genk;Gent;1;0;1
17/09/2022;Charleroi;Westerlo;2;3;-1
17/09/2022;Cercle Brugge KSV;Oostende;2;2;0
17/09/2022;Waregem;St. Truiden;0;3;-3
17/09/2022;KV Mechelen;Leuven;0;0;0
16/09/2022;Antwerp;Seraing;2;1;1
11/09/2022;Gent;Waregem;2;0;2
11/09/2022;Royale Union SG;Genk;1;2;-1
11/09/2022;Cercle Brugge KSV;Antwerp;0;2;-2
11/09/2022;Westerlo;Anderlecht;2;1;1
10/09/2022;Leuven;Charleroi;3;2;1
10/09/2022;Oostende;Eupen;1;0;1
10/09/2022;Seraing;Club Brugge KV;0;2;-2
10/09/2022;Kortrijk;KV Mechelen;1;4;-3
09/09/2022;St. Truiden;St. Liege;1;2;-1
04/09/2022;Waregem;Royale Union SG;1;3;-2
04/09/2022;Charleroi;Gent;2;1;1
04/09/2022;Antwerp;Westerlo;3;0;3
04/09/2022;Anderlecht;Leuven;2;2;0
03/09/2022;St. Liege;Oostende;1;0;1
03/09/2022;Eupen;Kortrijk;0;1;-1
03/09/2022;KV Mechelen;Seraing;2;3;-1
03/09/2022;Genk;St. Truiden;0;0;0
02/09/2022;Club Brugge KV;Cercle Brugge KSV;4;0;4
01/09/2022;Anderlecht;Gent;0;1;-1
31/08/2022;Antwerp;Royale Union SG;4;2;2
28/08/2022;Westerlo;Eupen;0;1;-1
28/08/2022;Royale Union SG;Anderlecht;2;1;1
28/08/2022;Kortrijk;St. Liege;0;1;-1
28/08/2022;Gent;Antwerp;1;2;-1
27/08/2022;St. Truiden;KV Mechelen;3;1;2
27/08/2022;Cercle Brugge KSV;Waregem;1;1;0
27/08/2022;Leuven;Oostende;2;1;1
27/08/2022;Seraing;Genk;0;4;-4
26/08/2022;Charleroi;Club Brugge KV;1;3;-2
21/08/2022;KV Mechelen;Westerlo;5;4;1
21/08/2022;St. Liege;Leuven;1;3;-2
21/08/2022;Waregem;Charleroi;1;3;-2
21/08/2022;Club Brugge KV;Kortrijk;2;1;1
20/08/2022;Genk;Cercle Brugge KSV;2;1;1
20/08/2022;Oostende;St. Truiden;0;1;-1
19/08/2022;Eupen;Seraing;1;3;-2
14/08/2022;Waregem;Genk;1;4;-3
14/08/2022;Leuven;Club Brugge KV;0;3;-3
14/08/2022;Eupen;Antwerp;0;1;-1
14/08/2022;St. Truiden;Anderlecht;0;3;-3
13/08/2022;Royale Union SG;Kortrijk;2;1;1
13/08/2022;Cercle Brugge KSV;KV Mechelen;0;0;0
13/08/2022;Seraing;Charleroi;0;1;-1
13/08/2022;Westerlo;St. Liege;4;2;2
12/08/2022;Oostende;Gent;1;3;-2
07/08/2022;Antwerp;Leuven;4;2;2
07/08/2022;Anderlecht;Seraing;3;1;2
07/08/2022;Gent;Westerlo;2;1;1
07/08/2022;St. Liege;Cercle Brugge KSV;2;0;2
06/08/2022;KV Mechelen;Royale Union SG;3;0;3
06/08/2022;Charleroi;Oostende;1;3;-2
06/08/2022;Kortrijk;St. Truiden;0;0;0
06/08/2022;Genk;Eupen;4;2;2
05/08/2022;Club Brugge KV;Waregem;1;1;0
31/07/2022;Antwerp;Waregem;1;0;1
31/07/2022;Seraing;Kortrijk;0;1;-1
31/07/2022;Eupen;Club Brugge KV;2;1;1
31/07/2022;Genk;St. Liege;3;1;2
30/07/2022;Gent;St. Truiden;1;1;0
30/07/2022;Leuven;Westerlo;2;0;2
30/07/2022;Oostende;KV Mechelen;2;1;1
30/07/2022;Cercle Brugge KSV;Anderlecht;1;0;1
29/07/2022;Royale Union SG;Charleroi;1;0;1
24/07/2022;Westerlo;Cercle Brugge KSV;2;0;2
24/07/2022;Anderlecht;Oostende;2;0;2
24/07/2022;KV Mechelen;Antwerp;0;2;-2
24/07/2022;Club Brugge KV;Genk;3;2;1
23/07/2022;St. Truiden;Royale Union SG;1;1;0
23/07/2022;Kortrijk;Leuven;0;2;-2
23/07/2022;Waregem;Seraing;2;0;2
23/07/2022;Charleroi;Eupen;3;1;2
22/07/2022;St. Liege;Gent;2;2;0
