DATE;HOME;AWAY;FTHG;FTAG;DIFF
28/05/2024;Hartberg;Austria Vienna;0;1;-1
24/05/2024;Austria Vienna;Hartberg;2;1;1
21/05/2024;Wolfsberger AC;Austria Vienna;1;2;-1
19/05/2024;Salzburg;LASK;7;1;6
19/05/2024;SK Rapid;Hartberg;0;3;-3
19/05/2024;Sturm Graz;A. Klagenfurt;2;0;2
18/05/2024;Altach;A. Lustenau;2;2;0
18/05/2024;BW Linz;Austria Vienna;1;2;-1
18/05/2024;Wolfsberger AC;Tirol;3;1;2
12/05/2024;A. Klagenfurt;SK Rapid;0;1;-1
12/05/2024;Hartberg;Salzburg;1;5;-4
12/05/2024;LASK;Sturm Graz;2;2;0
11/05/2024;A. Lustenau;BW Linz;1;0;1
11/05/2024;Austria Vienna;Wolfsberger AC;0;4;-4
11/05/2024;Tirol;Altach;0;1;-1
05/05/2024;SK Rapid;Salzburg;2;0;2
05/05/2024;A. Klagenfurt;LASK;0;2;-2
05/05/2024;Sturm Graz;Hartberg;1;1;0
04/05/2024;Altach;Wolfsberger AC;0;1;-1
04/05/2024;BW Linz;Tirol;3;2;1
03/05/2024;A. Lustenau;Austria Vienna;2;0;2
28/04/2024;Salzburg;Sturm Graz;2;2;0
28/04/2024;Hartberg;A. Klagenfurt;3;2;1
28/04/2024;LASK;SK Rapid;5;0;5
27/04/2024;Tirol;A. Lustenau;0;0;0
27/04/2024;Wolfsberger AC;BW Linz;0;2;-2
26/04/2024;Austria Vienna;Altach;2;2;0
24/04/2024;SK Rapid;Sturm Graz;1;3;-2
24/04/2024;A. Klagenfurt;Salzburg;4;3;1
24/04/2024;Hartberg;LASK;1;2;-1
23/04/2024;BW Linz;Altach;2;1;1
23/04/2024;A. Lustenau;Wolfsberger AC;1;2;-1
23/04/2024;Tirol;Austria Vienna;1;0;1
21/04/2024;Salzburg;A. Klagenfurt;4;2;2
21/04/2024;LASK;Hartberg;1;3;-2
20/04/2024;Altach;BW Linz;2;2;0
20/04/2024;Austria Vienna;Tirol;3;0;3
20/04/2024;Wolfsberger AC;A. Lustenau;1;1;0
19/04/2024;Sturm Graz;SK Rapid;1;0;1
14/04/2024;SK Rapid;A. Klagenfurt;1;1;0
14/04/2024;Hartberg;Sturm Graz;1;3;-2
13/04/2024;A. Lustenau;Altach;0;1;-1
13/04/2024;Tirol;BW Linz;2;1;1
13/04/2024;Wolfsberger AC;Austria Vienna;0;1;-1
12/04/2024;LASK;Salzburg;3;1;2
07/04/2024;Salzburg;SK Rapid;1;1;0
07/04/2024;A. Klagenfurt;Hartberg;2;2;0
07/04/2024;Sturm Graz;LASK;1;0;1
06/04/2024;BW Linz;Wolfsberger AC;0;0;0
06/04/2024;Austria Vienna;A. Lustenau;1;1;0
05/04/2024;Altach;Tirol;0;0;0
31/03/2024;Sturm Graz;Salzburg;0;1;-1
31/03/2024;Hartberg;SK Rapid;0;3;-3
31/03/2024;LASK;A. Klagenfurt;1;0;1
30/03/2024;A. Lustenau;Tirol;1;2;-1
30/03/2024;Wolfsberger AC;Altach;0;0;0
29/03/2024;Austria Vienna;BW Linz;0;0;0
17/03/2024;Salzburg;Hartberg;5;1;4
17/03/2024;A. Klagenfurt;Sturm Graz;0;4;-4
16/03/2024;Altach;Austria Vienna;1;1;0
16/03/2024;BW Linz;A. Lustenau;0;0;0
16/03/2024;Tirol;Wolfsberger AC;1;1;0
15/03/2024;SK Rapid;LASK;0;0;0
10/03/2024;A. Klagenfurt;SK Rapid;1;1;0
10/03/2024;A. Lustenau;BW Linz;2;0;2
10/03/2024;Austria Vienna;Tirol;2;0;2
10/03/2024;Hartberg;Sturm Graz;1;1;0
10/03/2024;Wolfsberger AC;Altach;1;1;0
09/03/2024;LASK;Salzburg;0;1;-1
03/03/2024;Altach;LASK;0;0;0
03/03/2024;BW Linz;Austria Vienna;1;2;-1
03/03/2024;Salzburg;A. Klagenfurt;1;0;1
03/03/2024;SK Rapid;A. Lustenau;1;1;0
03/03/2024;Sturm Graz;Wolfsberger AC;4;0;4
03/03/2024;Tirol;Hartberg;1;0;1
25/02/2024;SK Rapid;Austria Vienna;3;0;3
25/02/2024;A. Klagenfurt;BW Linz;2;0;2
25/02/2024;Tirol;Sturm Graz;0;2;-2
24/02/2024;Altach;Hartberg;1;2;-1
24/02/2024;LASK;Wolfsberger AC;0;1;-1
24/02/2024;Salzburg;A. Lustenau;7;0;7
18/02/2024;Sturm Graz;SK Rapid;1;1;0
18/02/2024;A. Lustenau;A. Klagenfurt;0;1;-1
18/02/2024;Hartberg;LASK;0;0;0
17/02/2024;Austria Vienna;Altach;2;1;1
17/02/2024;BW Linz;Salzburg;1;1;0
17/02/2024;Wolfsberger AC;Tirol;4;1;3
11/02/2024;LASK;A. Klagenfurt;2;2;0
11/02/2024;Tirol;A. Lustenau;0;2;-2
11/02/2024;Wolfsberger AC;SK Rapid;0;2;-2
10/02/2024;Altach;BW Linz;1;1;0
10/02/2024;Austria Vienna;Hartberg;3;1;2
09/02/2024;Salzburg;Sturm Graz;1;1;0
10/12/2023;Sturm Graz;Altach;1;0;1
10/12/2023;BW Linz;Tirol;1;2;-1
10/12/2023;Hartberg;Wolfsberger AC;2;0;2
09/12/2023;A. Klagenfurt;Austria Vienna;2;2;0
09/12/2023;A. Lustenau;LASK;1;3;-2
09/12/2023;SK Rapid;Salzburg;0;1;-1
05/12/2023;Altach;A. Lustenau;3;0;3
05/12/2023;Tirol;SK Rapid;1;2;-1
04/12/2023;A. Klagenfurt;Hartberg;1;1;0
03/12/2023;Austria Vienna;LASK;0;0;0
03/12/2023;BW Linz;Sturm Graz;1;1;0
03/12/2023;Salzburg;Wolfsberger AC;1;0;1
26/11/2023;SK Rapid;BW Linz;1;0;1
26/11/2023;Altach;A. Klagenfurt;0;1;-1
26/11/2023;Wolfsberger AC;Austria Vienna;1;0;1
25/11/2023;LASK;Tirol;1;0;1
25/11/2023;Salzburg;Hartberg;3;2;1
25/11/2023;Sturm Graz;A. Lustenau;2;0;2
12/11/2023;Austria Vienna;Salzburg;0;0;0
12/11/2023;A. Klagenfurt;Sturm Graz;0;3;-3
12/11/2023;BW Linz;LASK;2;0;2
11/11/2023;A. Lustenau;Wolfsberger AC;2;3;-1
11/11/2023;Hartberg;SK Rapid;1;0;1
11/11/2023;Tirol;Altach;5;1;4
05/11/2023;LASK;Sturm Graz;3;1;2
05/11/2023;Altach;SK Rapid;0;2;-2
05/11/2023;Hartberg;BW Linz;3;2;1
04/11/2023;Austria Vienna;A. Lustenau;1;0;1
04/11/2023;Tirol;Salzburg;0;2;-2
04/11/2023;Wolfsberger AC;A. Klagenfurt;4;0;4
29/10/2023;SK Rapid;LASK;3;3;0
29/10/2023;A. Lustenau;Hartberg;0;4;-4
29/10/2023;Sturm Graz;Austria Vienna;0;1;-1
28/10/2023;A. Klagenfurt;Tirol;1;0;1
28/10/2023;BW Linz;Wolfsberger AC;2;0;2
28/10/2023;Salzburg;Altach;3;0;3
22/10/2023;SK Rapid;A. Klagenfurt;2;3;-1
22/10/2023;Altach;Wolfsberger AC;0;0;0
22/10/2023;Tirol;Austria Vienna;0;2;-2
21/10/2023;BW Linz;A. Lustenau;0;0;0
21/10/2023;Salzburg;LASK;0;1;-1
21/10/2023;Sturm Graz;Hartberg;2;1;1
08/10/2023;A. Klagenfurt;Salzburg;2;2;0
08/10/2023;LASK;Altach;1;0;1
08/10/2023;Wolfsberger AC;Sturm Graz;1;2;-1
07/10/2023;A. Lustenau;SK Rapid;0;5;-5
07/10/2023;Austria Vienna;BW Linz;4;0;4
07/10/2023;Hartberg;Tirol;3;0;3
01/10/2023;Austria Vienna;SK Rapid;0;0;0
01/10/2023;Hartberg;Altach;0;0;0
01/10/2023;Sturm Graz;Tirol;1;0;1
30/09/2023;A. Lustenau;Salzburg;0;4;-4
30/09/2023;BW Linz;A. Klagenfurt;0;0;0
30/09/2023;Wolfsberger AC;LASK;2;1;1
24/09/2023;SK Rapid;Sturm Graz;1;1;0
24/09/2023;Altach;Austria Vienna;2;1;1
24/09/2023;LASK;Hartberg;0;0;0
23/09/2023;A. Klagenfurt;A. Lustenau;1;0;1
23/09/2023;Salzburg;BW Linz;0;1;-1
23/09/2023;Tirol;Wolfsberger AC;2;3;-1
17/09/2023;SK Rapid;Wolfsberger AC;3;3;0
17/09/2023;A. Lustenau;Tirol;2;3;-1
17/09/2023;Hartberg;Austria Vienna;2;1;1
16/09/2023;Sturm Graz;Salzburg;2;2;0
16/09/2023;A. Klagenfurt;LASK;1;3;-2
16/09/2023;BW Linz;Altach;1;1;0
03/09/2023;Austria Vienna;A. Klagenfurt;2;2;0
03/09/2023;LASK;A. Lustenau;2;0;2
03/09/2023;Salzburg;SK Rapid;2;0;2
02/09/2023;Altach;Sturm Graz;1;2;-1
02/09/2023;Tirol;BW Linz;2;4;-2
02/09/2023;Wolfsberger AC;Hartberg;0;3;-3
27/08/2023;Hartberg;A. Klagenfurt;0;3;-3
27/08/2023;LASK;Austria Vienna;2;0;2
27/08/2023;SK Rapid;Tirol;1;1;0
26/08/2023;A. Lustenau;Altach;0;3;-3
26/08/2023;Sturm Graz;BW Linz;4;1;3
26/08/2023;Wolfsberger AC;Salzburg;1;2;-1
20/08/2023;Austria Vienna;Wolfsberger AC;0;0;0
20/08/2023;BW Linz;SK Rapid;0;5;-5
20/08/2023;Hartberg;Salzburg;1;5;-4
19/08/2023;A. Klagenfurt;Altach;1;1;0
19/08/2023;A. Lustenau;Sturm Graz;0;1;-1
19/08/2023;Tirol;LASK;1;1;0
13/08/2023;Altach;Tirol;1;0;1
13/08/2023;Salzburg;Austria Vienna;2;0;2
13/08/2023;SK Rapid;Hartberg;0;1;-1
12/08/2023;LASK;BW Linz;2;0;2
12/08/2023;Sturm Graz;A. Klagenfurt;0;0;0
12/08/2023;Wolfsberger AC;A. Lustenau;1;1;0
09/08/2023;A. Klagenfurt;Wolfsberger AC;2;2;0
06/08/2023;A. Lustenau;Austria Vienna;0;2;-2
06/08/2023;BW Linz;Hartberg;3;3;0
06/08/2023;Salzburg;Tirol;3;0;3
05/08/2023;Sturm Graz;LASK;2;0;2
05/08/2023;SK Rapid;Altach;4;0;4
30/07/2023;Austria Vienna;Sturm Graz;0;3;-3
29/07/2023;Altach;Salzburg;0;2;-2
29/07/2023;Hartberg;A. Lustenau;2;2;0
29/07/2023;Tirol;A. Klagenfurt;1;3;-2
29/07/2023;Wolfsberger AC;BW Linz;2;1;1
28/07/2023;LASK;SK Rapid;1;1;0
