DATE;HOME;AWAY;FTHG;FTAG;DIFF
27/05/2024;Dusseldorf;Bochum;0;4;-4
23/05/2024;Bochum;Dusseldorf;0;3;-3
18/05/2024;Bayer Leverkusen;Augsburg;2;1;1
18/05/2024;Dortmund;Darmstadt;4;0;4
18/05/2024;Eintracht Frankfurt;RB Leipzig;2;2;0
18/05/2024;Heidenheim;FC Koln;4;1;3
18/05/2024;Hoffenheim;Bayern Munich;4;2;2
18/05/2024;Stuttgart;B. Monchengladbach;4;0;4
18/05/2024;Union Berlin;Freiburg;2;1;1
18/05/2024;Werder Bremen;Bochum;4;1;3
18/05/2024;Wolfsburg;Mainz;1;3;-2
12/05/2024;Bochum;Bayer Leverkusen;0;5;-5
12/05/2024;Bayern Munich;Wolfsburg;2;0;2
12/05/2024;Darmstadt;Hoffenheim;0;6;-6
11/05/2024;Mainz;Dortmund;3;0;3
11/05/2024;B. Monchengladbach;Eintracht Frankfurt;1;1;0
11/05/2024;FC Koln;Union Berlin;3;2;1
11/05/2024;Freiburg;Heidenheim;1;1;0
11/05/2024;RB Leipzig;Werder Bremen;1;1;0
10/05/2024;Augsburg;Stuttgart;0;1;-1
05/05/2024;Heidenheim;Mainz;1;1;0
05/05/2024;Eintracht Frankfurt;Bayer Leverkusen;1;5;-4
05/05/2024;Union Berlin;Bochum;3;4;-1
04/05/2024;FC Koln;Freiburg;0;0;0
04/05/2024;Dortmund;Augsburg;5;1;4
04/05/2024;Stuttgart;Bayern Munich;3;1;2
04/05/2024;Werder Bremen;B. Monchengladbach;2;2;0
04/05/2024;Wolfsburg;Darmstadt;3;0;3
03/05/2024;Hoffenheim;RB Leipzig;1;1;0
28/04/2024;Darmstadt;Heidenheim;0;1;-1
28/04/2024;Mainz;FC Koln;1;1;0
28/04/2024;B. Monchengladbach;Union Berlin;0;0;0
27/04/2024;Bayer Leverkusen;Stuttgart;2;2;0
27/04/2024;Augsburg;Werder Bremen;0;3;-3
27/04/2024;Bayern Munich;Eintracht Frankfurt;2;1;1
27/04/2024;Freiburg;Wolfsburg;1;2;-1
27/04/2024;RB Leipzig;Dortmund;4;1;3
26/04/2024;Bochum;Hoffenheim;3;2;1
21/04/2024;Freiburg;Mainz;1;1;0
21/04/2024;Dortmund;Bayer Leverkusen;1;1;0
21/04/2024;Werder Bremen;Stuttgart;2;1;1
20/04/2024;Union Berlin;Bayern Munich;1;5;-4
20/04/2024;FC Koln;Darmstadt;0;2;-2
20/04/2024;Heidenheim;RB Leipzig;1;2;-1
20/04/2024;Hoffenheim;B. Monchengladbach;4;3;1
20/04/2024;Wolfsburg;Bochum;1;0;1
19/04/2024;Eintracht Frankfurt;Augsburg;3;1;2
14/04/2024;Bayer Leverkusen;Werder Bremen;5;0;5
14/04/2024;Darmstadt;Freiburg;0;1;-1
13/04/2024;Stuttgart;Eintracht Frankfurt;3;0;3
13/04/2024;B. Monchengladbach;Dortmund;1;2;-1
13/04/2024;Bayern Munich;FC Koln;2;0;2
13/04/2024;Bochum;Heidenheim;1;1;0
13/04/2024;Mainz;Hoffenheim;4;1;3
13/04/2024;RB Leipzig;Wolfsburg;3;0;3
12/04/2024;Augsburg;Union Berlin;2;0;2
07/04/2024;Wolfsburg;B. Monchengladbach;1;3;-2
07/04/2024;Hoffenheim;Augsburg;3;1;2
06/04/2024;Dortmund;Stuttgart;0;1;-1
06/04/2024;FC Koln;Bochum;2;1;1
06/04/2024;Freiburg;RB Leipzig;1;4;-3
06/04/2024;Heidenheim;Bayern Munich;3;2;1
06/04/2024;Mainz;Darmstadt;4;0;4
06/04/2024;Union Berlin;Bayer Leverkusen;0;1;-1
05/04/2024;Eintracht Frankfurt;Werder Bremen;1;1;0
31/03/2024;Bochum;Darmstadt;2;2;0
31/03/2024;Stuttgart;Heidenheim;3;3;0
31/03/2024;Augsburg;FC Koln;1;1;0
30/03/2024;Bayern Munich;Dortmund;0;2;-2
30/03/2024;B. Monchengladbach;Freiburg;0;3;-3
30/03/2024;Bayer Leverkusen;Hoffenheim;2;1;1
30/03/2024;Eintracht Frankfurt;Union Berlin;0;0;0
30/03/2024;RB Leipzig;Mainz;0;0;0
30/03/2024;Werder Bremen;Wolfsburg;0;2;-2
17/03/2024;Dortmund;Eintracht Frankfurt;3;1;2
17/03/2024;Freiburg;Bayer Leverkusen;2;3;-1
16/03/2024;Hoffenheim;Stuttgart;0;3;-3
16/03/2024;Darmstadt;Bayern Munich;2;5;-3
16/03/2024;Heidenheim;B. Monchengladbach;1;1;0
16/03/2024;Mainz;Bochum;2;0;2
16/03/2024;Union Berlin;Werder Bremen;2;1;1
16/03/2024;Wolfsburg;Augsburg;1;3;-2
15/03/2024;FC Koln;RB Leipzig;1;5;-4
10/03/2024;Bayer Leverkusen;Wolfsburg;2;0;2
10/03/2024;Eintracht Frankfurt;Hoffenheim;3;1;2
10/03/2024;Bochum;Freiburg;1;2;-1
09/03/2024;Werder Bremen;Dortmund;1;2;-1
09/03/2024;Augsburg;Heidenheim;1;0;1
09/03/2024;B. Monchengladbach;FC Koln;3;3;0
09/03/2024;Bayern Munich;Mainz;8;1;7
09/03/2024;RB Leipzig;Darmstadt;2;0;2
08/03/2024;Stuttgart;Union Berlin;2;0;2
03/03/2024;Hoffenheim;Werder Bremen;2;1;1
03/03/2024;FC Koln;Bayer Leverkusen;0;2;-2
02/03/2024;Wolfsburg;Stuttgart;2;3;-1
02/03/2024;Bochum;RB Leipzig;1;4;-3
02/03/2024;Darmstadt;Augsburg;0;6;-6
02/03/2024;Heidenheim;Eintracht Frankfurt;1;2;-1
02/03/2024;Mainz;B. Monchengladbach;1;1;0
02/03/2024;Union Berlin;Dortmund;0;2;-2
01/03/2024;Freiburg;Bayern Munich;2;2;0
25/02/2024;Augsburg;Freiburg;2;1;1
25/02/2024;Dortmund;Hoffenheim;2;3;-1
25/02/2024;Eintracht Frankfurt;Wolfsburg;2;2;0
24/02/2024;Bayern Munich;RB Leipzig;2;1;1
24/02/2024;B. Monchengladbach;Bochum;5;2;3
24/02/2024;Stuttgart;FC Koln;1;1;0
24/02/2024;Union Berlin;Heidenheim;2;2;0
24/02/2024;Werder Bremen;Darmstadt;1;1;0
23/02/2024;Bayer Leverkusen;Mainz;2;1;1
18/02/2024;Bochum;Bayern Munich;3;2;1
18/02/2024;Freiburg;Eintracht Frankfurt;3;3;0
17/02/2024;RB Leipzig;B. Monchengladbach;2;0;2
17/02/2024;Darmstadt;Stuttgart;1;2;-1
17/02/2024;Heidenheim;Bayer Leverkusen;1;2;-1
17/02/2024;Hoffenheim;Union Berlin;0;1;-1
17/02/2024;Mainz;Augsburg;1;0;1
17/02/2024;Wolfsburg;Dortmund;1;1;0
16/02/2024;FC Koln;Werder Bremen;0;1;-1
11/02/2024;Hoffenheim;FC Koln;1;1;0
11/02/2024;Stuttgart;Mainz;3;1;2
10/02/2024;Bayer Leverkusen;Bayern Munich;3;0;3
10/02/2024;Augsburg;RB Leipzig;2;2;0
10/02/2024;B. Monchengladbach;Darmstadt;0;0;0
10/02/2024;Eintracht Frankfurt;Bochum;1;1;0
10/02/2024;Union Berlin;Wolfsburg;1;0;1
10/02/2024;Werder Bremen;Heidenheim;1;2;-1
09/02/2024;Dortmund;Freiburg;3;0;3
07/02/2024;Mainz;Union Berlin;1;1;0
04/02/2024;RB Leipzig;Union Berlin;2;0;2
04/02/2024;Wolfsburg;Hoffenheim;2;2;0
03/02/2024;FC Koln;Eintracht Frankfurt;2;0;2
03/02/2024;Bayern Munich;B. Monchengladbach;3;1;2
03/02/2024;Bochum;Augsburg;1;1;0
03/02/2024;Darmstadt;Bayer Leverkusen;0;2;-2
03/02/2024;Freiburg;Stuttgart;1;3;-2
03/02/2024;Mainz;Werder Bremen;0;1;-1
02/02/2024;Heidenheim;Dortmund;0;0;0
28/01/2024;Dortmund;Bochum;3;1;2
28/01/2024;Union Berlin;Darmstadt;1;0;1
27/01/2024;Bayer Leverkusen;B. Monchengladbach;0;0;0
27/01/2024;Augsburg;Bayern Munich;2;3;-1
27/01/2024;Hoffenheim;Heidenheim;1;1;0
27/01/2024;Stuttgart;RB Leipzig;5;2;3
27/01/2024;Werder Bremen;Freiburg;3;1;2
27/01/2024;Wolfsburg;FC Koln;1;1;0
26/01/2024;Eintracht Frankfurt;Mainz;1;0;1
24/01/2024;Bayern Munich;Union Berlin;1;0;1
21/01/2024;B. Monchengladbach;Augsburg;1;2;-1
21/01/2024;Bayern Munich;Werder Bremen;0;1;-1
20/01/2024;RB Leipzig;Bayer Leverkusen;2;3;-1
20/01/2024;Bochum;Stuttgart;1;0;1
20/01/2024;Darmstadt;Eintracht Frankfurt;2;2;0
20/01/2024;FC Koln;Dortmund;0;4;-4
20/01/2024;Freiburg;Hoffenheim;3;2;1
20/01/2024;Heidenheim;Wolfsburg;1;1;0
14/01/2024;B. Monchengladbach;Stuttgart;3;1;2
14/01/2024;Bochum;Werder Bremen;1;1;0
13/01/2024;Darmstadt;Dortmund;0;3;-3
13/01/2024;Augsburg;Bayer Leverkusen;0;1;-1
13/01/2024;FC Koln;Heidenheim;1;1;0
13/01/2024;Freiburg;Union Berlin;0;0;0
13/01/2024;Mainz;Wolfsburg;1;1;0
13/01/2024;RB Leipzig;Eintracht Frankfurt;0;1;-1
12/01/2024;Bayern Munich;Hoffenheim;3;0;3
20/12/2023;Bayer Leverkusen;Bochum;4;0;4
20/12/2023;Eintracht Frankfurt;B. Monchengladbach;2;1;1
20/12/2023;Heidenheim;Freiburg;3;2;1
20/12/2023;Stuttgart;Augsburg;3;0;3
20/12/2023;Wolfsburg;Bayern Munich;1;2;-1
20/12/2023;Union Berlin;FC Koln;2;0;2
19/12/2023;Dortmund;Mainz;1;1;0
19/12/2023;Hoffenheim;Darmstadt;3;3;0
19/12/2023;Werder Bremen;RB Leipzig;1;1;0
17/12/2023;Bayern Munich;Stuttgart;3;0;3
17/12/2023;Bayer Leverkusen;Eintracht Frankfurt;3;0;3
17/12/2023;Freiburg;FC Koln;2;0;2
16/12/2023;RB Leipzig;Hoffenheim;3;1;2
16/12/2023;Augsburg;Dortmund;1;1;0
16/12/2023;Bochum;Union Berlin;3;0;3
16/12/2023;Darmstadt;Wolfsburg;0;1;-1
16/12/2023;Mainz;Heidenheim;0;1;-1
15/12/2023;B. Monchengladbach;Werder Bremen;2;2;0
10/12/2023;FC Koln;Mainz;0;0;0
10/12/2023;Stuttgart;Bayer Leverkusen;1;1;0
09/12/2023;Dortmund;RB Leipzig;2;3;-1
09/12/2023;Eintracht Frankfurt;Bayern Munich;5;1;4
09/12/2023;Heidenheim;Darmstadt;3;2;1
09/12/2023;Union Berlin;B. Monchengladbach;3;1;2
09/12/2023;Werder Bremen;Augsburg;2;0;2
09/12/2023;Wolfsburg;Freiburg;0;1;-1
08/12/2023;Hoffenheim;Bochum;3;1;2
03/12/2023;Augsburg;Eintracht Frankfurt;2;1;1
03/12/2023;Bayer Leverkusen;Dortmund;1;1;0
03/12/2023;Mainz;Freiburg;0;1;-1
02/12/2023;Stuttgart;Werder Bremen;2;0;2
02/12/2023;B. Monchengladbach;Hoffenheim;2;1;1
02/12/2023;Bochum;Wolfsburg;3;1;2
02/12/2023;RB Leipzig;Heidenheim;2;1;1
01/12/2023;Darmstadt;FC Koln;0;1;-1
26/11/2023;Hoffenheim;Mainz;1;1;0
26/11/2023;Heidenheim;Bochum;0;0;0
25/11/2023;Eintracht Frankfurt;Stuttgart;1;2;-1
25/11/2023;Dortmund;B. Monchengladbach;4;2;2
25/11/2023;Freiburg;Darmstadt;1;1;0
25/11/2023;Union Berlin;Augsburg;1;1;0
25/11/2023;Werder Bremen;Bayer Leverkusen;0;3;-3
25/11/2023;Wolfsburg;RB Leipzig;2;1;1
24/11/2023;FC Koln;Bayern Munich;0;1;-1
12/11/2023;RB Leipzig;Freiburg;3;1;2
12/11/2023;Werder Bremen;Eintracht Frankfurt;2;2;0
12/11/2023;Bayer Leverkusen;Union Berlin;4;0;4
11/11/2023;Bochum;FC Koln;1;1;0
11/11/2023;Augsburg;Hoffenheim;1;1;0
11/11/2023;Bayern Munich;Heidenheim;4;2;2
11/11/2023;Darmstadt;Mainz;0;0;0
11/11/2023;Stuttgart;Dortmund;2;1;1
10/11/2023;B. Monchengladbach;Wolfsburg;4;0;4
05/11/2023;Heidenheim;Stuttgart;2;0;2
05/11/2023;Wolfsburg;Werder Bremen;2;2;0
04/11/2023;Dortmund;Bayern Munich;0;4;-4
04/11/2023;FC Koln;Augsburg;1;1;0
04/11/2023;Freiburg;B. Monchengladbach;3;3;0
04/11/2023;Hoffenheim;Bayer Leverkusen;2;3;-1
04/11/2023;Mainz;RB Leipzig;2;0;2
04/11/2023;Union Berlin;Eintracht Frankfurt;0;3;-3
03/11/2023;Darmstadt;Bochum;1;2;-1
29/10/2023;Bayer Leverkusen;Freiburg;2;1;1
29/10/2023;Eintracht Frankfurt;Dortmund;3;3;0
28/10/2023;RB Leipzig;FC Koln;6;0;6
28/10/2023;Augsburg;Wolfsburg;3;2;1
28/10/2023;B. Monchengladbach;Heidenheim;2;1;1
28/10/2023;Bayern Munich;Darmstadt;8;0;8
28/10/2023;Stuttgart;Hoffenheim;2;3;-1
28/10/2023;Werder Bremen;Union Berlin;2;0;2
27/10/2023;Bochum;Mainz;2;2;0
22/10/2023;Heidenheim;Augsburg;2;5;-3
22/10/2023;FC Koln;B. Monchengladbach;3;1;2
21/10/2023;Mainz;Bayern Munich;1;3;-2
21/10/2023;Darmstadt;RB Leipzig;1;3;-2
21/10/2023;Freiburg;Bochum;2;1;1
21/10/2023;Hoffenheim;Eintracht Frankfurt;1;3;-2
21/10/2023;Union Berlin;Stuttgart;0;3;-3
21/10/2023;Wolfsburg;Bayer Leverkusen;1;2;-1
20/10/2023;Dortmund;Werder Bremen;1;0;1
08/10/2023;Eintracht Frankfurt;Heidenheim;2;0;2
08/10/2023;Bayern Munich;Freiburg;3;0;3
08/10/2023;Bayer Leverkusen;FC Koln;3;0;3
07/10/2023;Werder Bremen;Hoffenheim;2;3;-1
07/10/2023;Augsburg;Darmstadt;1;2;-1
07/10/2023;Dortmund;Union Berlin;4;2;2
07/10/2023;RB Leipzig;Bochum;0;0;0
07/10/2023;Stuttgart;Wolfsburg;3;1;2
06/10/2023;B. Monchengladbach;Mainz;2;2;0
01/10/2023;Freiburg;Augsburg;2;0;2
01/10/2023;Darmstadt;Werder Bremen;4;2;2
30/09/2023;RB Leipzig;Bayern Munich;2;2;0
30/09/2023;Bochum;B. Monchengladbach;1;3;-2
30/09/2023;FC Koln;Stuttgart;0;2;-2
30/09/2023;Heidenheim;Union Berlin;1;0;1
30/09/2023;Mainz;Bayer Leverkusen;0;3;-3
30/09/2023;Wolfsburg;Eintracht Frankfurt;2;0;2
29/09/2023;Hoffenheim;Dortmund;1;3;-2
24/09/2023;Eintracht Frankfurt;Freiburg;0;0;0
24/09/2023;Bayer Leverkusen;Heidenheim;4;1;3
23/09/2023;Werder Bremen;FC Koln;2;1;1
23/09/2023;Augsburg;Mainz;2;1;1
23/09/2023;B. Monchengladbach;RB Leipzig;0;1;-1
23/09/2023;Bayern Munich;Bochum;7;0;7
23/09/2023;Dortmund;Wolfsburg;1;0;1
23/09/2023;Union Berlin;Hoffenheim;0;2;-2
22/09/2023;Stuttgart;Darmstadt;3;1;2
17/09/2023;Darmstadt;B. Monchengladbach;3;3;0
17/09/2023;Heidenheim;Werder Bremen;4;2;2
16/09/2023;Bochum;Eintracht Frankfurt;1;1;0
16/09/2023;FC Koln;Hoffenheim;1;3;-2
16/09/2023;Freiburg;Dortmund;2;4;-2
16/09/2023;Mainz;Stuttgart;1;3;-2
16/09/2023;RB Leipzig;Augsburg;3;0;3
16/09/2023;Wolfsburg;Union Berlin;2;1;1
15/09/2023;Bayern Munich;Bayer Leverkusen;2;2;0
03/09/2023;Union Berlin;RB Leipzig;0;3;-3
03/09/2023;Eintracht Frankfurt;FC Koln;1;1;0
02/09/2023;B. Monchengladbach;Bayern Munich;1;2;-1
02/09/2023;Augsburg;Bochum;2;2;0
02/09/2023;Bayer Leverkusen;Darmstadt;5;1;4
02/09/2023;Hoffenheim;Wolfsburg;3;1;2
02/09/2023;Stuttgart;Freiburg;5;0;5
02/09/2023;Werder Bremen;Mainz;4;0;4
01/09/2023;Dortmund;Heidenheim;2;2;0
27/08/2023;Bayern Munich;Augsburg;3;1;2
27/08/2023;Mainz;Eintracht Frankfurt;1;1;0
26/08/2023;B. Monchengladbach;Bayer Leverkusen;0;3;-3
26/08/2023;Bochum;Dortmund;1;1;0
26/08/2023;Darmstadt;Union Berlin;1;4;-3
26/08/2023;FC Koln;Wolfsburg;1;2;-1
26/08/2023;Freiburg;Werder Bremen;1;0;1
26/08/2023;Heidenheim;Hoffenheim;2;3;-1
25/08/2023;RB Leipzig;Stuttgart;5;1;4
20/08/2023;Eintracht Frankfurt;Darmstadt;1;0;1
20/08/2023;Union Berlin;Mainz;4;1;3
19/08/2023;Dortmund;FC Koln;1;0;1
19/08/2023;Augsburg;B. Monchengladbach;4;4;0
19/08/2023;Bayer Leverkusen;RB Leipzig;3;2;1
19/08/2023;Hoffenheim;Freiburg;1;2;-1
19/08/2023;Stuttgart;Bochum;5;0;5
19/08/2023;Wolfsburg;Heidenheim;2;0;2
18/08/2023;Werder Bremen;Bayern Munich;0;4;-4
