DATE;HOME;AWAY;FTHG;FTAG;DIFF
02/06/2024;Metz;St Etienne;2;2;0
30/05/2024;St Etienne;Metz;2;1;1
24/05/2024;St Etienne;Rodez;2;0;2
21/05/2024;Rodez;Paris FC;3;2;1
19/05/2024;Le Havre;Marseille;1;2;-1
19/05/2024;Lens;Montpellier;2;2;0
19/05/2024;Lille;Nice;2;2;0
19/05/2024;Lorient;Clermont;5;0;5
19/05/2024;Lyon;Strasbourg;2;1;1
19/05/2024;Metz;PSG;0;2;-2
19/05/2024;Monaco;Nantes;4;0;4
19/05/2024;Reims;Rennes;2;1;1
19/05/2024;Toulouse;Brest;0;3;-3
15/05/2024;Nice;PSG;1;2;-1
15/05/2024;Reims;Marseille;1;0;1
12/05/2024;Clermont;Lyon;0;1;-1
12/05/2024;Marseille;Lorient;3;1;2
12/05/2024;Montpellier;Monaco;0;2;-2
12/05/2024;Nantes;Lille;1;2;-1
12/05/2024;PSG;Toulouse;1;3;-2
12/05/2024;Rennes;Lens;1;1;0
12/05/2024;Strasbourg;Metz;2;1;1
10/05/2024;Brest;Reims;1;1;0
10/05/2024;Nice;Le Havre;1;0;1
06/05/2024;Lille;Lyon;3;4;-1
04/05/2024;Brest;Nantes;0;0;0
04/05/2024;Metz;Rennes;2;3;-1
04/05/2024;Monaco;Clermont;4;1;3
04/05/2024;Le Havre;Strasbourg;3;1;2
03/05/2024;Lens;Lorient;2;0;2
03/05/2024;Toulouse;Montpellier;1;2;-1
28/04/2024;Marseille;Lens;2;1;1
28/04/2024;Lyon;Monaco;3;2;1
28/04/2024;Rennes;Brest;4;5;-1
28/04/2024;Clermont;Reims;4;1;3
28/04/2024;Lorient;Toulouse;1;2;-1
28/04/2024;Strasbourg;Nice;1;3;-2
28/04/2024;Metz;Lille;1;2;-1
27/04/2024;PSG;Le Havre;3;3;0
26/04/2024;Montpellier;Nantes;1;1;0
24/04/2024;Marseille;Nice;2;2;0
24/04/2024;Monaco;Lille;1;0;1
24/04/2024;Lorient;PSG;1;4;-3
21/04/2024;PSG;Lyon;4;1;3
21/04/2024;Toulouse;Marseille;2;2;0
21/04/2024;Brest;Monaco;0;2;-2
21/04/2024;Le Havre;Metz;0;1;-1
21/04/2024;Lille;Strasbourg;1;0;1
21/04/2024;Reims;Montpellier;1;2;-1
20/04/2024;Lens;Clermont;1;0;1
20/04/2024;Nantes;Rennes;0;3;-3
19/04/2024;Nice;Lorient;3;0;3
14/04/2024;Lyon;Brest;4;3;1
14/04/2024;Clermont;Montpellier;1;1;0
14/04/2024;Le Havre;Nantes;0;1;-1
13/04/2024;Rennes;Toulouse;1;2;-1
13/04/2024;Strasbourg;Reims;3;1;2
12/04/2024;Metz;Lens;2;1;1
07/04/2024;Nantes;Lyon;1;3;-2
07/04/2024;Monaco;Rennes;1;0;1
07/04/2024;Montpellier;Lorient;2;0;2
07/04/2024;Reims;Nice;0;0;0
07/04/2024;Toulouse;Strasbourg;0;0;0
07/04/2024;Brest;Metz;4;3;1
06/04/2024;PSG;Clermont;1;1;0
06/04/2024;Lens;Le Havre;1;1;0
05/04/2024;Lille;Marseille;3;1;2
31/03/2024;Marseille;PSG;0;2;-2
31/03/2024;Strasbourg;Rennes;2;0;2
31/03/2024;Clermont;Toulouse;0;3;-3
31/03/2024;Le Havre;Montpellier;0;2;-2
31/03/2024;Nice;Nantes;1;2;-1
31/03/2024;Lorient;Brest;0;1;-1
30/03/2024;Lyon;Reims;1;1;0
30/03/2024;Metz;Monaco;2;5;-3
29/03/2024;Lille;Lens;2;1;1
17/03/2024;Montpellier;PSG;2;6;-4
17/03/2024;Rennes;Marseille;2;0;2
17/03/2024;Clermont;Le Havre;2;1;1
17/03/2024;Monaco;Lorient;2;2;0
17/03/2024;Reims;Metz;2;1;1
17/03/2024;Brest;Lille;1;1;0
16/03/2024;Lens;Nice;1;3;-2
16/03/2024;Nantes;Strasbourg;1;3;-2
15/03/2024;Toulouse;Lyon;2;3;-1
10/03/2024;Marseille;Nantes;2;0;2
10/03/2024;Lille;Rennes;2;2;0
10/03/2024;Le Havre;Toulouse;1;0;1
10/03/2024;Metz;Clermont;1;0;1
10/03/2024;Strasbourg;Monaco;0;1;-1
10/03/2024;PSG;Reims;2;2;0
09/03/2024;Lens;Brest;1;0;1
09/03/2024;Lorient;Lyon;0;2;-2
08/03/2024;Nice;Montpellier;1;2;-1
03/03/2024;Lyon;Lens;0;3;-3
03/03/2024;Rennes;Lorient;1;2;-1
03/03/2024;Brest;Le Havre;1;0;1
03/03/2024;Montpellier;Strasbourg;2;2;0
03/03/2024;Nantes;Metz;0;2;-2
03/03/2024;Toulouse;Nice;2;1;1
02/03/2024;Clermont;Marseille;1;5;-4
02/03/2024;Reims;Lille;0;1;-1
01/03/2024;Monaco;PSG;0;0;0
25/02/2024;Marseille;Montpellier;4;1;3
25/02/2024;PSG;Rennes;1;1;0
25/02/2024;Le Havre;Reims;1;2;-1
25/02/2024;Nice;Clermont;0;0;0
25/02/2024;Toulouse;Lille;3;1;2
25/02/2024;Lens;Monaco;2;3;-1
24/02/2024;Strasbourg;Brest;0;3;-3
24/02/2024;Lorient;Nantes;0;1;-1
23/02/2024;Metz;Lyon;1;2;-1
18/02/2024;Brest;Marseille;1;0;1
18/02/2024;Reims;Lens;1;1;0
18/02/2024;Monaco;Toulouse;1;2;-1
18/02/2024;Montpellier;Metz;3;0;3
18/02/2024;Rennes;Clermont;3;1;2
18/02/2024;Strasbourg;Lorient;1;3;-2
17/02/2024;Nantes;PSG;0;2;-2
17/02/2024;Lille;Le Havre;3;0;3
16/02/2024;Lyon;Nice;1;0;1
11/02/2024;Nice;Monaco;2;3;-1
11/02/2024;Montpellier;Lyon;1;2;-1
11/02/2024;Clermont;Brest;1;1;0
11/02/2024;Lorient;Reims;2;0;2
11/02/2024;Toulouse;Nantes;1;2;-1
11/02/2024;Le Havre;Rennes;0;1;-1
10/02/2024;PSG;Lille;3;1;2
10/02/2024;Lens;Strasbourg;3;1;2
09/02/2024;Marseille;Metz;1;1;0
04/02/2024;Lyon;Marseille;1;0;1
04/02/2024;Brest;Nice;0;0;0
04/02/2024;Lille;Clermont;4;0;4
04/02/2024;Metz;Lorient;1;2;-1
04/02/2024;Reims;Toulouse;2;3;-1
04/02/2024;Monaco;Le Havre;1;1;0
03/02/2024;Nantes;Lens;0;1;-1
03/02/2024;Rennes;Montpellier;2;1;1
02/02/2024;Strasbourg;PSG;1;2;-1
28/01/2024;PSG;Brest;2;2;0
28/01/2024;Toulouse;Lens;0;2;-2
28/01/2024;Clermont;Strasbourg;1;1;0
28/01/2024;Lorient;Le Havre;3;3;0
28/01/2024;Reims;Nantes;0;0;0
28/01/2024;Montpellier;Lille;0;0;0
27/01/2024;Marseille;Monaco;2;2;0
27/01/2024;Nice;Metz;1;0;1
26/01/2024;Lyon;Rennes;2;3;-1
14/01/2024;Lens;PSG;0;2;-2
14/01/2024;Le Havre;Lyon;3;1;2
14/01/2024;Brest;Montpellier;2;0;2
14/01/2024;Metz;Toulouse;0;1;-1
14/01/2024;Nantes;Clermont;1;2;-1
14/01/2024;Lille;Lorient;3;0;3
13/01/2024;Rennes;Nice;2;0;2
13/01/2024;Monaco;Reims;1;3;-2
12/01/2024;Marseille;Strasbourg;1;1;0
20/12/2023;Brest;Lorient;4;0;4
20/12/2023;Clermont;Rennes;1;3;-2
20/12/2023;Lyon;Nantes;1;0;1
20/12/2023;Montpellier;Marseille;1;1;0
20/12/2023;Nice;Lens;2;0;2
20/12/2023;PSG;Metz;3;1;2
20/12/2023;Reims;Le Havre;1;0;1
20/12/2023;Strasbourg;Lille;2;1;1
20/12/2023;Toulouse;Monaco;1;2;-1
17/12/2023;Lille;PSG;1;1;0
17/12/2023;Marseille;Clermont;2;1;1
17/12/2023;Lorient;Strasbourg;1;2;-1
17/12/2023;Metz;Montpellier;0;1;-1
17/12/2023;Toulouse;Rennes;0;0;0
17/12/2023;Nantes;Brest;0;2;-2
16/12/2023;Lens;Reims;2;0;2
16/12/2023;Le Havre;Nice;3;1;2
15/12/2023;Monaco;Lyon;0;1;-1
10/12/2023;Lorient;Marseille;2;4;-2
10/12/2023;Lyon;Toulouse;3;0;3
10/12/2023;Clermont;Lille;0;0;0
10/12/2023;Metz;Brest;0;1;-1
10/12/2023;Strasbourg;Le Havre;2;1;1
10/12/2023;Nice;Reims;2;1;1
09/12/2023;PSG;Nantes;2;1;1
09/12/2023;Rennes;Monaco;1;2;-1
08/12/2023;Montpellier;Lens;0;0;0
07/12/2023;Brest;Strasbourg;1;1;0
06/12/2023;Marseille;Lyon;3;0;3
03/12/2023;Marseille;Rennes;2;0;2
03/12/2023;Lille;Metz;2;0;2
03/12/2023;Brest;Clermont;3;0;3
03/12/2023;Monaco;Montpellier;2;0;2
03/12/2023;Toulouse;Lorient;1;1;0
03/12/2023;Le Havre;PSG;0;2;-2
02/12/2023;Nantes;Nice;1;0;1
02/12/2023;Lens;Lyon;3;2;1
01/12/2023;Reims;Strasbourg;2;1;1
29/11/2023;Montpellier;Clermont;1;1;0
26/11/2023;Lyon;Lille;0;2;-2
26/11/2023;Rennes;Reims;3;1;2
26/11/2023;Lorient;Metz;2;3;-1
26/11/2023;Montpellier;Brest;1;3;-2
26/11/2023;Nantes;Le Havre;0;0;0
26/11/2023;Nice;Toulouse;1;0;1
25/11/2023;Strasbourg;Marseille;1;1;0
25/11/2023;Clermont;Lens;0;3;-3
24/11/2023;PSG;Monaco;5;2;3
12/11/2023;Lens;Marseille;1;0;1
12/11/2023;Rennes;Lyon;0;1;-1
12/11/2023;Clermont;Lorient;1;0;1
12/11/2023;Lille;Toulouse;1;1;0
12/11/2023;Metz;Nantes;3;1;2
11/11/2023;Le Havre;Monaco;0;0;0
11/11/2023;Reims;PSG;0;3;-3
10/11/2023;Montpellier;Nice;0;0;0
05/11/2023;Nice;Rennes;2;0;2
05/11/2023;Monaco;Brest;2;0;2
05/11/2023;Nantes;Reims;0;1;-1
05/11/2023;Strasbourg;Clermont;0;0;0
05/11/2023;Toulouse;Le Havre;1;2;-1
05/11/2023;Lyon;Metz;1;1;0
04/11/2023;Marseille;Lille;0;0;0
04/11/2023;Lorient;Lens;0;0;0
03/11/2023;PSG;Montpellier;3;0;3
29/10/2023;Rennes;Strasbourg;1;1;0
29/10/2023;Lille;Monaco;2;0;2
29/10/2023;Metz;Le Havre;0;0;0
29/10/2023;Montpellier;Toulouse;3;0;3
29/10/2023;Brest;PSG;2;3;-1
28/10/2023;Lens;Nantes;4;0;4
28/10/2023;Reims;Lorient;1;0;1
27/10/2023;Clermont;Nice;0;1;-1
22/10/2023;Lyon;Clermont;1;2;-1
22/10/2023;Monaco;Metz;2;1;1
22/10/2023;Lille;Brest;1;0;1
22/10/2023;Nantes;Montpellier;2;0;2
22/10/2023;Toulouse;Reims;1;1;0
22/10/2023;Lorient;Rennes;2;1;1
21/10/2023;Nice;Marseille;1;0;1
21/10/2023;PSG;Strasbourg;3;0;3
20/10/2023;Le Havre;Lens;0;0;0
08/10/2023;Rennes;PSG;1;3;-2
08/10/2023;Lens;Lille;1;1;0
08/10/2023;Brest;Toulouse;1;1;0
08/10/2023;Lyon;Lorient;3;3;0
08/10/2023;Marseille;Le Havre;3;0;3
07/10/2023;Reims;Monaco;1;3;-2
07/10/2023;Metz;Nice;0;1;-1
06/10/2023;Strasbourg;Nantes;1;2;-1
01/10/2023;Rennes;Nantes;3;1;2
01/10/2023;Lorient;Montpellier;0;3;-3
01/10/2023;Le Havre;Lille;0;2;-2
01/10/2023;Nice;Brest;0;0;0
01/10/2023;Toulouse;Metz;3;0;3
01/10/2023;Reims;Lyon;2;0;2
30/09/2023;Monaco;Marseille;3;2;1
30/09/2023;Clermont;PSG;0;0;0
29/09/2023;Strasbourg;Lens;0;1;-1
26/09/2023;Lille;Reims;1;2;-1
24/09/2023;PSG;Marseille;4;0;4
24/09/2023;Montpellier;Rennes;0;0;0
24/09/2023;Le Havre;Clermont;2;1;1
24/09/2023;Lens;Toulouse;2;1;1
24/09/2023;Metz;Strasbourg;0;1;-1
23/09/2023;Brest;Lyon;1;0;1
23/09/2023;Nantes;Lorient;5;3;2
22/09/2023;Monaco;Nice;0;1;-1
17/09/2023;Lyon;Le Havre;0;0;0
17/09/2023;Marseille;Toulouse;0;0;0
17/09/2023;Clermont;Nantes;0;1;-1
17/09/2023;Reims;Brest;1;2;-1
17/09/2023;Strasbourg;Montpellier;2;2;0
17/09/2023;Lorient;Monaco;2;2;0
16/09/2023;Lens;Metz;0;1;-1
16/09/2023;Rennes;Lille;2;2;0
15/09/2023;PSG;Nice;2;3;-1
03/09/2023;Lyon;PSG;1;4;-3
03/09/2023;Nice;Strasbourg;2;0;2
03/09/2023;Le Havre;Lorient;3;0;3
03/09/2023;Lille;Montpellier;1;0;1
03/09/2023;Metz;Reims;2;2;0
03/09/2023;Toulouse;Clermont;2;2;0
02/09/2023;Monaco;Lens;3;0;3
02/09/2023;Brest;Rennes;0;0;0
01/09/2023;Nantes;Marseille;1;1;0
27/08/2023;Nice;Lyon;0;0;0
27/08/2023;Lorient;Lille;4;1;3
27/08/2023;Clermont;Metz;0;1;-1
27/08/2023;Montpellier;Reims;1;3;-2
27/08/2023;Strasbourg;Toulouse;2;0;2
27/08/2023;Rennes;Le Havre;2;2;0
26/08/2023;PSG;Lens;3;1;2
26/08/2023;Marseille;Brest;2;0;2
25/08/2023;Nantes;Monaco;3;3;0
20/08/2023;Lens;Rennes;1;1;0
20/08/2023;Monaco;Strasbourg;3;0;3
20/08/2023;Le Havre;Brest;1;2;-1
20/08/2023;Lorient;Nice;1;1;0
20/08/2023;Reims;Clermont;2;0;2
20/08/2023;Lille;Nantes;2;0;2
19/08/2023;Toulouse;PSG;1;1;0
19/08/2023;Lyon;Montpellier;1;4;-3
18/08/2023;Metz;Marseille;2;2;0
13/08/2023;Strasbourg;Lyon;2;1;1
13/08/2023;Rennes;Metz;5;1;4
13/08/2023;Clermont;Monaco;2;4;-2
13/08/2023;Montpellier;Le Havre;2;2;0
13/08/2023;Nantes;Toulouse;1;2;-1
13/08/2023;Brest;Lens;3;2;1
12/08/2023;PSG;Lorient;0;0;0
12/08/2023;Marseille;Reims;2;1;1
11/08/2023;Nice;Lille;1;1;0
